00000000200000000001
00001000200000100001
00000000201000000001
00000000200000010001
00010000200000000000
00000000000000000000
00000000200000000000
00000000200000000000
00000000200000000000
00000000200000000000
00000000220000000000
00000000020000000000